akanga	akanga+N+SG
akanga-itá	akanga+N+PL
akangaiwasawa	akangaiwasawa+N+SG
akangaiwasawa-itá	akangaiwasawa+N+PL
akangatara	akangatara+N+SG
akangatara-itá	akangatara+N+PL
akarí	akarí+N+SG
akarí-itá	akarí+N+PL
akayú	akayú+N+SG
akayú-itá	akayú+N+PL
akayú	akayú+N+SG
akayú-itá	akayú+N+PL
akayutiwa	akayutiwa+N+SG
akayutiwa-itá	akayutiwa+N+PL
amana	amana+N+SG
amana-itá	amana+N+PL
amanawasú	amanawasú+N+SG
amanawasú-itá	amanawasú+N+PL
amaniú	amaniú+N+SG
amaniú-itá	amaniú+N+PL
amũ	amũ+N+SG
amũ-itá	amũ+N+PL
anama	anama+N+SG
anama-itá	anama+N+PL
anga	anga+N+SG
anga-itá	anga+N+PL
apigawa	apigawa+N+SG
apigawa-itá	apigawa+N+PL
ara	ara+N+SG
ara-itá	ara+N+PL
ara	ara+N+SG
ara-itá	ara+N+PL
ara	ara+N+SG
ara-itá	ara+N+PL
arara	arara+N+SG
arara-itá	arara+N+PL
ararapewa	ararapewa+N+SG
ararapewa-itá	ararapewa+N+PL
arasá	arasá+N+SG
arasá-itá	arasá+N+PL
arawara	arawara+N+SG
arawara-itá	arawara+N+PL
aria	aria+N+SG
aria-itá	aria+N+PL
awa	awa+N+SG
awa-itá	awa+N+PL
awatí	awatí+N+SG
awatí-itá	awatí+N+PL
baniwa	baniwa+N+SG
baniwa-itá	baniwa+N+PL
buya	buya+N+SG
buya-itá	buya+N+PL
darapí	darapí+N+SG
darapí-itá	darapí+N+PL
desana	desana+N+SG
desana-itá	desana+N+PL
gantĩ	gantĩ+N+SG
gantĩ-itá	gantĩ+N+PL
garapá	garapá+N+SG
garapá-itá	garapá+N+PL
igara	igara+N+SG
igara-itá	igara+N+PL
igarapé	igarapé+N+SG
igarapé-itá	igarapé+N+PL
igarité	igarité+N+SG
igarité-itá	igarité+N+PL
ií	ií+N+SG
ií-itá	ií+N+PL
ipadú	ipadú+N+SG
ipadú-itá	ipadú+N+PL
íra	íra+N+SG
íra-itá	íra+N+PL
irirú	irirú+N+SG
irirú-itá	irirú+N+PL
itá	itá+N+SG
itá-itá	itá+N+PL
itaité	itaité+N+SG
itaité-itá	itaité+N+PL
íwa	íwa+N+SG
íwa-itá	íwa+N+PL
iwaka	iwaka+N+SG
iwaka-itá	iwaka+N+PL
iwaté	iwaté+N+SG
iwaté-itá	iwaté+N+PL
iwí	iwí+N+SG
iwí-itá	iwí+N+PL
iwí-murutinga	iwí-murutinga+N+SG
iwí-murutinga-itá	iwí-murutinga+N+PL
iwisé	iwisé+N+SG
iwisé-itá	iwisé+N+PL
iwitú	iwitú+N+SG
iwitú-itá	iwitú+N+PL
kaá	kaá+N+SG
kaá-itá	kaá+N+PL
kakurí	kakurí+N+SG
kakurí-itá	kakurí+N+PL
kambí	kambí+N+SG
kambí-itá	kambí+N+PL
kamixá	kamixá+N+SG
kamixá-itá	kamixá+N+PL
kamundusara	kamundusara+N+SG
kamundusara-itá	kamundusara+N+PL
kamutí	kamutí+N+SG
kamutí-itá	kamutí+N+PL
kandirú	kandirú+N+SG
kandirú-itá	kandirú+N+PL
kanhimu	kanhimu+N+SG
kanhimu-itá	kanhimu+N+PL
kará	kará+N+SG
kará-itá	kará+N+PL
kariwa	kariwa+N+SG
kariwa-itá	kariwa+N+PL
karuka	karuka+N+SG
karuka-itá	karuka+N+PL
katusawa	katusawa+N+SG
katusawa-itá	katusawa+N+PL
kawarú	kawarú+N+SG
kawarú-itá	kawarú+N+PL
kawera	kawera+N+SG
kawera-itá	kawera+N+PL
kawĩ	kawĩ+N+SG
kawĩ-itá	kawĩ+N+PL
kawoka	kawoka+N+SG
kawoka-itá	kawoka+N+PL
kaxirí	kaxirí+N+SG
kaxirí-itá	kaxirí+N+PL
kaxiwera	kaxiwera+N+SG
kaxiwera-itá	kaxiwera+N+PL
kiínha	kiínha+N+SG
kiínha-itá	kiínha+N+PL
kirimbasawa	kirimbasawa+N+SG
kirimbasawa-itá	kirimbasawa+N+PL
kisé	kisé+N+SG
kisé-itá	kisé+N+PL
kitikasara	kitikasara+N+SG
kitikasara-itá	kitikasara+N+PL
kiwíra	kiwíra+N+SG
kiwíra-itá	kiwíra+N+PL
kuiwara	kuiwara+N+SG
kuiwara-itá	kuiwara+N+PL
kumaíwa	kumaíwa+N+SG
kumaíwa-itá	kumaíwa+N+PL
kumandamirĩ	kumandamirĩ+N+SG
kumandamirĩ-itá	kumandamirĩ+N+PL
kunhã	kunhã+N+SG
kunhã-itá	kunhã+N+PL
kunhãmukú	kunhãmukú+N+SG
kunhãmukú-itá	kunhãmukú+N+PL
kupé	kupé+N+SG
kupé-itá	kupé+N+PL
kupiĩ	kupiĩ+N+SG
kupiĩ-itá	kupiĩ+N+PL
kupixawa	kupixawa+N+SG
kupixawa-itá	kupixawa+N+PL
kupuasú	kupuasú+N+SG
kupuasú-itá	kupuasú+N+PL
kurasí	kurasí+N+SG
kurasí-itá	kurasí+N+PL
kurumĩ	kurumĩ+N+SG
kurumĩ-itá	kurumĩ+N+PL
kurumĩwasú	kurumĩwasú+N+SG
kurumĩwasú-itá	kurumĩwasú+N+PL
kuya	kuya+N+SG
kuya-itá	kuya+N+PL
kwara	kwara+N+SG
kwara-itá	kwara+N+PL
kwema	kwema+N+SG
kwema-itá	kwema+N+PL
maã	maã+N+SG
maã-itá	maã+N+PL
mairí	mairí+N+SG
mairí-itá	mairí+N+PL
makaxera	makaxera+N+SG
makaxera-itá	makaxera+N+PL
makira	makira+N+SG
makira-itá	makira+N+PL
manawara	manawara+N+SG
manawara-itá	manawara+N+PL
manha	manha+N+SG
manha-itá	manha+N+PL
maniaka	maniaka+N+SG
maniaka-itá	maniaka+N+PL
manikwera	manikwera+N+SG
manikwera-itá	manikwera+N+PL
maniwa	maniwa+N+SG
maniwa-itá	maniwa+N+PL
maniwatiwa	maniwatiwa+N+SG
maniwatiwa-itá	maniwatiwa+N+PL
maramunhangara	maramunhangara+N+SG
maramunhangara-itá	maramunhangara+N+PL
marandua	marandua+N+SG
marandua-itá	marandua+N+PL
marika	marika+N+SG
marika-itá	marika+N+PL
mbuesara	mbuesara+N+SG
mbuesara-itá	mbuesara+N+PL
mbuesawa	mbuesawa+N+SG
mbuesawa-itá	mbuesawa+N+PL
meẽsara	meẽsara+N+SG
meẽsara-itá	meẽsara+N+PL
memũingara	memũingara+N+SG
memũingara-itá	memũingara+N+PL
memũitawa	memũitawa+N+SG
memũitawa-itá	memũitawa+N+PL
memũitendawa	memũitendawa+N+SG
memũitendawa-itá	memũitendawa+N+PL
mena	mena+N+SG
mena-itá	mena+N+PL
meyú	meyú+N+SG
meyú-itá	meyú+N+PL
miapé	miapé+N+SG
miapé-itá	miapé+N+PL
mimbira	mimbira+N+SG
mimbira-itá	mimbira+N+PL
mimiwara	mimiwara+N+SG
mimiwara-itá	mimiwara+N+PL
mirá	mirá+N+SG
mirá-itá	mirá+N+PL
mira	mira+N+SG
mira-itá	mira+N+PL
mitima	mitima+N+SG
mitima-itá	mitima+N+PL
mituú	mituú+N+SG
mituú-itá	mituú+N+PL
mũ	mũ+N+SG
mũ-itá	mũ+N+PL
mundawasú	mundawasú+N+SG
mundawasú-itá	mundawasú+N+PL
munhangawa	munhangawa+N+SG
munhangawa-itá	munhangawa+N+PL
mupinimasara	mupinimasara+N+SG
mupinimasara-itá	mupinimasara+N+PL
murakí	murakí+N+SG
murakí-itá	murakí+N+PL
murakimukũi	murakimukũi+N+SG
murakimukũi-itá	murakimukũi+N+PL
murakimusapiri	murakimusapiri+N+SG
murakimusapiri-itá	murakimusapiri+N+PL
murakipí	murakipí+N+SG
murakipí-itá	murakipí+N+PL
murasí	murasí+N+SG
murasí-itá	murasí+N+PL
nambí	nambí+N+SG
nambí-itá	nambí+N+PL
naná	naná+N+SG
naná-itá	naná+N+PL
nheenga	nheenga+N+SG
nheenga-itá	nheenga+N+PL
nheengarisara	nheengarisara+N+SG
nheengarisara-itá	nheengarisara+N+PL
nheengarisawa	nheengarisawa+N+SG
nheengarisawa-itá	nheengarisawa+N+PL
nheengatú	nheengatú+N+SG
nheengatú-itá	nheengatú+N+PL
pakuatiwa	pakuatiwa+N+SG
pakuatiwa-itá	pakuatiwa+N+PL
papera	papera+N+SG
papera-itá	papera+N+PL
paranã	paranã+N+SG
paranã-itá	paranã+N+PL
paranãpura	paranãpura+N+SG
paranãpura-itá	paranãpura+N+PL
Paranãwasú	Paranãwasú+N+SG
Paranãwasú-itá	Paranãwasú+N+PL
paranãwasú	paranãwasú+N+SG
paranãwasú-itá	paranãwasú+N+PL
pausawa	pausawa+N+SG
pausawa-itá	pausawa+N+PL
paya	paya+N+SG
paya-itá	paya+N+PL
payé	payé+N+SG
payé-itá	payé+N+PL
pé	pé+N+ABS+SG
pé-itá	pé+N+ABS+PL
rapé	pé+N+CONT+SG
rapé-itá	pé+N+CONT+PL
sapé)	pé+N+NCONT+SG
sapé)-itá	pé+N+NCONT+PL
pepú	pepú+N+SG
pepú-itá	pepú+N+PL
perewa	perewa+N+SG
perewa-itá	perewa+N+PL
pi	pi+N+SG
pi-itá	pi+N+PL
piá	piá+N+SG
piá-itá	piá+N+PL
pikasú	pikasú+N+SG
pikasú-itá	pikasú+N+PL
pinaitikasara	pinaitikasara+N+SG
pinaitikasara-itá	pinaitikasara+N+PL
pindá	pindá+N+SG
pindá-itá	pindá+N+PL
pindaíwa	pindaíwa+N+SG
pindaíwa-itá	pindaíwa+N+PL
pindawa	pindawa+N+SG
pindawa-itá	pindawa+N+PL
pinimasara	pinimasara+N+SG
pinimasara-itá	pinimasara+N+PL
pinimasawa	pinimasawa+N+SG
pinimasawa-itá	pinimasawa+N+PL
pinimatawa	pinimatawa+N+SG
pinimatawa-itá	pinimatawa+N+PL
pira	pira+N+SG
pira-itá	pira+N+PL
pirá	pirá+N+SG
pirá-itá	pirá+N+PL
piraíwa	piraíwa+N+SG
piraíwa-itá	piraíwa+N+PL
pirarukú	pirarukú+N+SG
pirarukú-itá	pirarukú+N+PL
pirera	pirera+N+SG
pirera-itá	pirera+N+PL
pisawera	pisawera+N+SG
pisawera-itá	pisawera+N+PL
pisayé	pisayé+N+SG
pisayé-itá	pisayé+N+PL
pitera	pitera+N+SG
pitera-itá	pitera+N+PL
pituna	pituna+N+SG
pituna-itá	pituna+N+PL
pixana	pixana+N+SG
pixana-itá	pixana+N+PL
pixunasawa	pixunasawa+N+SG
pixunasawa-itá	pixunasawa+N+PL
pu	pu+N+SG
pu-itá	pu+N+PL
purakisawa	purakisawa+N+SG
purakisawa-itá	purakisawa+N+PL
purandusawa	purandusawa+N+SG
purandusawa-itá	purandusawa+N+PL
purangasawa	purangasawa+N+SG
purangasawa-itá	purangasawa+N+PL
purasisawa	purasisawa+N+SG
purasisawa-itá	purasisawa+N+PL
pururé	pururé+N+SG
pururé-itá	pururé+N+PL
putiá	putiá+N+SG
putiá-itá	putiá+N+PL
putira	putira+N+SG
putira-itá	putira+N+PL
puxirungara	puxirungara+N+SG
puxirungara-itá	puxirungara+N+PL
pwãpé	pwãpé+N+SG
pwãpé-itá	pwãpé+N+PL
saanga	saanga+N+ABS+SG
saanga-itá	saanga+N+ABS+PL
raanga	saanga+N+CONT+SG
raanga-itá	saanga+N+CONT+PL
saanga)	saanga+N+NCONT+SG
saanga)-itá	saanga+N+NCONT+PL
saisusawa	saisusawa+N+SG
saisusawa-itá	saisusawa+N+PL
sakanga	sakanga+N+ABS+SG
sakanga-itá	sakanga+N+ABS+PL
rakanga	sakanga+N+CONT+SG
rakanga-itá	sakanga+N+CONT+PL
sakanga)	sakanga+N+NCONT+SG
sakanga)-itá	sakanga+N+NCONT+PL
sakusawa	sakusawa+N+ABS+SG
sakusawa-itá	sakusawa+N+ABS+PL
rakusawa	sakusawa+N+CONT+SG
rakusawa-itá	sakusawa+N+CONT+PL
sakusawa)	sakusawa+N+NCONT+SG
sakusawa)-itá	sakusawa+N+NCONT+PL
sangawa	sangawa+N+ABS+SG
sangawa-itá	sangawa+N+ABS+PL
rangawa	sangawa+N+CONT+SG
rangawa-itá	sangawa+N+CONT+PL
sangawa)	sangawa+N+NCONT+SG
sangawa)-itá	sangawa+N+NCONT+PL
sanha	sanha+N+ABS+SG
sanha-itá	sanha+N+ABS+PL
ranha	sanha+N+CONT+SG
ranha-itá	sanha+N+CONT+PL
sanha)	sanha+N+NCONT+SG
sanha)-itá	sanha+N+NCONT+PL
sapú	sapú+N+ABS+SG
sapú-itá	sapú+N+ABS+PL
rapú	sapú+N+CONT+SG
rapú-itá	sapú+N+CONT+PL
sapú)	sapú+N+NCONT+SG
sapú)-itá	sapú+N+NCONT+PL
sapukaya	sapukaya+N+SG
sapukaya-itá	sapukaya+N+PL
sasisawa	sasisawa+N+SG
sasisawa-itá	sasisawa+N+PL
saurú	saurú+N+SG
saurú-itá	saurú+N+PL
sawa	sawa+N+ABS+SG
sawa-itá	sawa+N+ABS+PL
rawa	sawa+N+CONT+SG
rawa-itá	sawa+N+CONT+PL
sawa)	sawa+N+NCONT+SG
sawa)-itá	sawa+N+NCONT+PL
seẽ	seẽ+N+SG
seẽ-itá	seẽ+N+PL
sekuyara	sekuyara+N+ABS+SG
sekuyara-itá	sekuyara+N+ABS+PL
rekuyara	sekuyara+N+CONT+SG
rekuyara-itá	sekuyara+N+CONT+PL
sekuyara)	sekuyara+N+NCONT+SG
sekuyara)-itá	sekuyara+N+NCONT+PL
sekuyaramirĩ	sekuyaramirĩ+N+ABS+SG
sekuyaramirĩ-itá	sekuyaramirĩ+N+ABS+PL
r	sekuyaramirĩ+N+CONT+SG
r-itá	sekuyaramirĩ+N+CONT+PL
s)	sekuyaramirĩ+N+NCONT+SG
s)-itá	sekuyaramirĩ+N+NCONT+PL
sepí	sepí+N+SG
sepí-itá	sepí+N+PL
sera	sera+N+ABS+SG
sera-itá	sera+N+ABS+PL
rera	sera+N+CONT+SG
rera-itá	sera+N+CONT+PL
sera)	sera+N+NCONT+SG
sera)-itá	sera+N+NCONT+PL
sesá	sesá+N+ABS+SG
sesá-itá	sesá+N+ABS+PL
resá	sesá+N+CONT+SG
resá-itá	sesá+N+CONT+PL
sesá)	sesá+N+NCONT+SG
sesá)-itá	sesá+N+NCONT+PL
sesayukisé	sesayukisé+N+ABS+SG
sesayukisé-itá	sesayukisé+N+ABS+PL
resayukisé	sesayukisé+N+CONT+SG
resayukisé-itá	sesayukisé+N+CONT+PL
sesayukisé)	sesayukisé+N+NCONT+SG
sesayukisé)-itá	sesayukisé+N+NCONT+PL
setimã	setimã+N+ABS+SG
setimã-itá	setimã+N+ABS+PL
retimã	setimã+N+CONT+SG
retimã-itá	setimã+N+CONT+PL
setimã)	setimã+N+NCONT+SG
setimã)-itá	setimã+N+NCONT+PL
sikiesawa	sikiesawa+N+SG
sikiesawa-itá	sikiesawa+N+PL
sikwesawa	sikwesawa+N+ABS+SG
sikwesawa-itá	sikwesawa+N+ABS+PL
rikwesawa	sikwesawa+N+CONT+SG
rikwesawa-itá	sikwesawa+N+CONT+PL
sikwesawa)	sikwesawa+N+NCONT+SG
sikwesawa)-itá	sikwesawa+N+NCONT+PL
simirikú	simirikú+N+ABS+SG
simirikú-itá	simirikú+N+ABS+PL
rimirikú	simirikú+N+CONT+SG
rimirikú-itá	simirikú+N+CONT+PL
simirikú)	simirikú+N+NCONT+SG
simirikú)-itá	simirikú+N+NCONT+PL
simirikú-putawa	simirikú-putawa+N+ABS+SG
simirikú-putawa-itá	simirikú-putawa+N+ABS+PL
r	simirikú-putawa+N+CONT+SG
r-itá	simirikú-putawa+N+CONT+PL
s)	simirikú-putawa+N+NCONT+SG
s)-itá	simirikú-putawa+N+NCONT+PL
suá	suá+N+ABS+SG
suá-itá	suá+N+ABS+PL
ruá	suá+N+CONT+SG
ruá-itá	suá+N+CONT+PL
suá)	suá+N+NCONT+SG
suá)-itá	suá+N+NCONT+PL
suasú	suasú+N+SG
suasú-itá	suasú+N+PL
suaxara	suaxara+N+ABS+SG
suaxara-itá	suaxara+N+ABS+PL
ruaxara	suaxara+N+CONT+SG
ruaxara-itá	suaxara+N+CONT+PL
suaxara)	suaxara+N+NCONT+SG
suaxara)-itá	suaxara+N+NCONT+PL
suaya	suaya+N+ABS+SG
suaya-itá	suaya+N+ABS+PL
ruaya	suaya+N+CONT+SG
ruaya-itá	suaya+N+CONT+PL
suaya)	suaya+N+NCONT+SG
suaya)-itá	suaya+N+NCONT+PL
sukwera	sukwera+N+ABS+SG
sukwera-itá	sukwera+N+ABS+PL
rukwera	sukwera+N+CONT+SG
rukwera-itá	sukwera+N+CONT+PL
sukwera)	sukwera+N+NCONT+SG
sukwera)-itá	sukwera+N+NCONT+PL
sumitera	sumitera+N+ABS+SG
sumitera-itá	sumitera+N+ABS+PL
rumitera	sumitera+N+CONT+SG
rumitera-itá	sumitera+N+CONT+PL
sumitera)	sumitera+N+NCONT+SG
sumitera)-itá	sumitera+N+NCONT+PL
sumuara	sumuara+N+ABS+SG
sumuara-itá	sumuara+N+ABS+PL
rumuara	sumuara+N+CONT+SG
rumuara-itá	sumuara+N+CONT+PL
sumuara)	sumuara+N+NCONT+SG
sumuara)-itá	sumuara+N+NCONT+PL
supapáu	supapáu+N+SG
supapáu-itá	supapáu+N+PL
supiá	supiá+N+ABS+SG
supiá-itá	supiá+N+ABS+PL
rupiá	supiá+N+CONT+SG
rupiá-itá	supiá+N+CONT+PL
supiá)	supiá+N+NCONT+SG
supiá)-itá	supiá+N+NCONT+PL
supisawa	supisawa+N+SG
supisawa-itá	supisawa+N+PL
rupítá)	supitá+N+CONT+SG
rupítá)-itá	supitá+N+CONT+PL
rupítá)	supitá+N+CONT+SG
rupítá)-itá	supitá+N+CONT+PL
surara	surara+N+SG
surara-itá	surara+N+PL
surisawa	surisawa+N+ABS+SG
surisawa-itá	surisawa+N+ABS+PL
r	surisawa+N+CONT+SG
r-itá	surisawa+N+CONT+PL
s)	surisawa+N+NCONT+SG
s)-itá	surisawa+N+NCONT+PL
suú	suú+N+SG
suú-itá	suú+N+PL
taína	taína+N+SG
taína-itá	taína+N+PL
tainasawa	tainasawa+N+SG
tainasawa-itá	tainasawa+N+PL
taínha	taínha+N+ABS+SG
taínha-itá	taínha+N+ABS+PL
raínha	taínha+N+CONT+SG
raínha-itá	taínha+N+CONT+PL
saínha)	taínha+N+NCONT+SG
saínha)-itá	taínha+N+NCONT+PL
taíra	taíra+N+ABS+SG
taíra-itá	taíra+N+ABS+PL
raíra	taíra+N+CONT+SG
raíra-itá	taíra+N+CONT+PL
taíra)	taíra+N+NCONT+SG
taíra)-itá	taíra+N+NCONT+PL
taití	taití+N+ABS+SG
taití-itá	taití+N+ABS+PL
raití	taití+N+CONT+SG
raití-itá	taití+N+CONT+PL
saití)	taití+N+NCONT+SG
saití)-itá	taití+N+NCONT+PL
takua	takua+N+ABS+SG
takua-itá	takua+N+ABS+PL
rakua	takua+N+CONT+SG
rakua-itá	takua+N+CONT+PL
sakua)	takua+N+NCONT+SG
sakua)-itá	takua+N+NCONT+PL
takwara	takwara+N+SG
takwara-itá	takwara+N+PL
tamanduá	tamanduá+N+SG
tamanduá-itá	tamanduá+N+PL
tamuatá	tamuatá+N+SG
tamuatá-itá	tamuatá+N+PL
tamunha	tamunha+N+ABS+SG
tamunha-itá	tamunha+N+ABS+PL
ramunha	tamunha+N+CONT+SG
ramunha-itá	tamunha+N+CONT+PL
samunha)	tamunha+N+NCONT+SG
samunha)-itá	tamunha+N+NCONT+PL
tapekua	tapekua+N+SG
tapekua-itá	tapekua+N+PL
tapereiwá	tapereiwá+N+SG
tapereiwá-itá	tapereiwá+N+PL
tapiaka	tapiaka+N+SG
tapiaka-itá	tapiaka+N+PL
tapiíra	tapiíra+N+SG
tapiíra-itá	tapiíra+N+PL
tapixawa	tapixawa+N+ABS+SG
tapixawa-itá	tapixawa+N+ABS+PL
rapixawa	tapixawa+N+CONT+SG
rapixawa-itá	tapixawa+N+CONT+PL
sapixawa)	tapixawa+N+NCONT+SG
sapixawa)-itá	tapixawa+N+NCONT+PL
tariíra	tariíra+N+SG
tariíra-itá	tariíra+N+PL
tatá	tatá+N+ABS+SG
tatá-itá	tatá+N+ABS+PL
ratá	tatá+N+CONT+SG
ratá-itá	tatá+N+CONT+PL
satá)	tatá+N+NCONT+SG
satá)-itá	tatá+N+NCONT+PL
tatú	tatú+N+SG
tatú-itá	tatú+N+PL
tawa	tawa+N+SG
tawa-itá	tawa+N+PL
tayera	tayera+N+ABS+SG
tayera-itá	tayera+N+ABS+PL
rayera	tayera+N+CONT+SG
rayera-itá	tayera+N+CONT+PL
tayera)	tayera+N+NCONT+SG
tayera)-itá	tayera+N+NCONT+PL
tembiwa	tembiwa+N+ABS+SG
tembiwa-itá	tembiwa+N+ABS+PL
rembiwa	tembiwa+N+CONT+SG
rembiwa-itá	tembiwa+N+CONT+PL
sembiwa)	tembiwa+N+NCONT+SG
sembiwa)-itá	tembiwa+N+NCONT+PL
tendawa	tendawa+N+ABS+SG
tendawa-itá	tendawa+N+ABS+PL
rendawa	tendawa+N+CONT+SG
rendawa-itá	tendawa+N+CONT+PL
sendawa)	tendawa+N+NCONT+SG
sendawa)-itá	tendawa+N+NCONT+PL
tendira	tendira+N+ABS+SG
tendira-itá	tendira+N+ABS+PL
rendira	tendira+N+CONT+SG
rendira-itá	tendira+N+CONT+PL
sendira)	tendira+N+NCONT+SG
sendira)-itá	tendira+N+NCONT+PL
tepusí	tepusí+N+ABS+SG
tepusí-itá	tepusí+N+ABS+PL
repusí	tepusí+N+CONT+SG
repusí-itá	tepusí+N+CONT+PL
sepusí)	tepusí+N+NCONT+SG
sepusí)-itá	tepusí+N+NCONT+PL
tetama	tetama+N+ABS+SG
tetama-itá	tetama+N+ABS+PL
retama	tetama+N+CONT+SG
retama-itá	tetama+N+CONT+PL
setama)	tetama+N+NCONT+SG
setama)-itá	tetama+N+NCONT+PL
teyú	teyú+N+SG
teyú-itá	teyú+N+PL
tianha	tianha+N+SG
tianha-itá	tianha+N+PL
tiapú	tiapú+N+SG
tiapú-itá	tiapú+N+PL
timbiú	timbiú+N+SG
timbiú-itá	timbiú+N+PL
tipiaka	tipiaka+N+SG
tipiaka-itá	tipiaka+N+PL
tipití	tipití+N+SG
tipití-itá	tipití+N+PL
tiputí	tiputí+N+ABS+SG
tiputí-itá	tiputí+N+ABS+PL
riputí	tiputí+N+CONT+SG
riputí-itá	tiputí+N+CONT+PL
siputí)	tiputí+N+NCONT+SG
siputí)-itá	tiputí+N+NCONT+PL
tĩsawa	tĩsawa+N+SG
tĩsawa-itá	tĩsawa+N+PL
tukana	tukana+N+SG
tukana-itá	tukana+N+PL
tukandira	tukandira+N+SG
tukandira-itá	tukandira+N+PL
Tupana	Tupana+N+SG
Tupana-itá	Tupana+N+PL
tupasá	tupasá+N+SG
tupasá-itá	tupasá+N+PL
tutira	tutira+N+SG
tutira-itá	tutira+N+PL
tuxawa	tuxawa+N+SG
tuxawa-itá	tuxawa+N+PL
tuyuka	tuyuka+N+SG
tuyuka-itá	tuyuka+N+PL
wirá	wirá+N+SG
wirá-itá	wirá+N+PL
wiramirĩ	wiramirĩ+N+SG
wiramirĩ-itá	wiramirĩ+N+PL
wirawasú	wirawasú+N+SG
wirawasú-itá	wirawasú+N+PL
witú	witú+N+SG
witú-itá	witú+N+PL
xibé	xibé+N+SG
xibé-itá	xibé+N+PL
xibuí	xibuí+N+SG
xibuí-itá	xibuí+N+PL
xipú	xipú+N+SG
xipú-itá	xipú+N+PL
xirura	xirura+N+SG
xirura-itá	xirura+N+PL
uí	uí+N+SG
uí-itá	uí+N+PL
uíwa	uíwa+N+SG
uíwa-itá	uíwa+N+PL
uka	uka+N+ABS+SG
uka-itá	uka+N+ABS+PL
ruka	uka+N+CONT+SG
ruka-itá	uka+N+CONT+PL
suka)	uka+N+NCONT+SG
suka)-itá	uka+N+NCONT+PL
ukapí	ukapí+N+ABS+SG
ukapí-itá	ukapí+N+ABS+PL
rukapí	ukapí+N+CONT+SG
rukapí-itá	ukapí+N+CONT+PL
sukapí)	ukapí+N+NCONT+SG
sukapí)-itá	ukapí+N+NCONT+PL
uka-pupekasara	uka-pupekasara+N+SG
uka-pupekasara-itá	uka-pupekasara+N+PL
ukara	ukara+N+SG
ukara-itá	ukara+N+PL
ukena	ukena+N+ABS+SG
ukena-itá	ukena+N+ABS+PL
rukena	ukena+N+CONT+SG
rukena-itá	ukena+N+CONT+PL
sukena)	ukena+N+NCONT+SG
sukena)-itá	ukena+N+NCONT+PL
urubú	urubú+N+SG
urubú-itá	urubú+N+PL
urupema	urupema+N+SG
urupema-itá	urupema+N+PL
waruá	waruá+N+SG
waruá-itá	waruá+N+PL
watasara	watasara+N+SG
watasara-itá	watasara+N+PL
watasawa	watasawa+N+SG
watasawa-itá	watasawa+N+PL
wawirú	wawirú+N+SG
wawirú-itá	wawirú+N+PL
yakumã	yakumã+N+SG
yakumã-itá	yakumã+N+PL
yamaxí	yamaxí+N+SG
yamaxí-itá	yamaxí+N+PL
yandú	yandú+N+SG
yandú-itá	yandú+N+PL
yanomami	yanomami+N+SG
yanomami-itá	yanomami+N+PL
yapuna	yapuna+N+SG
yapuna-itá	yapuna+N+PL
yapurá	yapurá+N+SG
yapurá-itá	yapurá+N+PL
yara	yara+N+SG
yara-itá	yara+N+PL
yasí	yasí+N+SG
yasí-itá	yasí+N+PL
yautí	yautí+N+SG
yautí-itá	yautí+N+PL
yawara	yawara+N+SG
yawara-itá	yawara+N+PL
yawareté	yawareté+N+SG
yawareté-itá	yawareté+N+PL
yawarí	yawarí+N+SG
yawarí-itá	yawarí+N+PL
yaxiusawa	yaxiusawa+N+SG
yaxiusawa-itá	yaxiusawa+N+PL
yepeawa	yepeawa+N+SG
yepeawa-itá	yepeawa+N+PL
yerimũ	yerimũ+N+SG
yerimũ-itá	yerimũ+N+PL
yukira	yukira+N+SG
yukira-itá	yukira+N+PL
yukisé	yukisé+N+SG
yukisé-itá	yukisé+N+PL
yukwakusawa	yukwakusawa+N+SG
yukwakusawa-itá	yukwakusawa+N+PL
yumasisawa	yumasisawa+N+SG
yumasisawa-itá	yumasisawa+N+PL
yumbuesara	yumbuesara+N+SG
yumbuesara-itá	yumbuesara+N+PL
yupatí	yupatí+N+SG
yupatí-itá	yupatí+N+PL
yupirisawa	yupirisawa+N+SG
yupirisawa-itá	yupirisawa+N+PL
yupirungawa	yupirungawa+N+SG
yupirungawa-itá	yupirungawa+N+PL
yurá	yurá+N+SG
yurá-itá	yurá+N+PL
yurú	yurú+N+SG
yurú-itá	yurú+N+PL
Yuruparí	Yuruparí+N+SG
Yuruparí-itá	Yuruparí+N+PL
yuwá	yuwá+N+SG
yuwá-itá	yuwá+N+PL
akangaíwa	akangaíwa+N+SG
akangaíwa-itá	akangaíwa+N+PL
ambira	ambira+N+SG
ambira-itá	ambira+N+PL
ikewara	ikewara+N+SG
ikewara-itá	ikewara+N+PL
irusanga	irusanga+N+SG
irusanga-itá	irusanga+N+PL
iwakapura	iwakapura+N+SG
iwakapura-itá	iwakapura+N+PL
iwakawara	iwakawara+N+SG
iwakawara-itá	iwakawara+N+PL
kaapura	kaapura+N+SG
kaapura-itá	kaapura+N+PL
kaawara	kaawara+N+SG
kaawara-itá	kaawara+N+PL
kirimbawa	kirimbawa+N+SG
kirimbawa-itá	kirimbawa+N+PL
kunhãwara	kunhãwara+N+SG
kunhãwara-itá	kunhãwara+N+PL
kuximawara	kuximawara+N+SG
kuximawara-itá	kuximawara+N+PL
maãsiyara	maãsiyara+N+SG
maãsiyara-itá	maãsiyara+N+PL
marupiara	marupiara+N+SG
marupiara-itá	marupiara+N+PL
membeka	membeka+N+SG
membeka-itá	membeka+N+PL
munhangara	munhangara+N+SG
munhangara-itá	munhangara+N+PL
pirasua	pirasua+N+SG
pirasua-itá	pirasua+N+PL
suriwara	suriwara+N+SG
suriwara-itá	suriwara+N+PL
tepusimanha	tepusimanha+N+SG
tepusimanha-itá	tepusimanha+N+PL
tuyuwé	tuyuwé+N+SG
tuyuwé-itá	tuyuwé+N+PL
ukawara	ukawara+N+SG
ukawara-itá	ukawara+N+PL
waimĩ	waimĩ+N+SG
waimĩ-itá	waimĩ+N+PL
